11111111111111111111111111111111111111111
1P0000E0000000000000000000000000000000001
10000000000000000C000000000000000C0000001
10000000000000000000000000000000000000001
10101010101010101010101010000C00001111111
10000000000000000000001011111111111111111
100000000000C0000000001011111111111111111
100000100000C0000000001011111111111111111
100000000000C0000000001011111111111111111
100000000000C0000000001011111111111111111
100000000000C0000000001011111111111111111
100000000000C0000000001011111111111111111
10000000000000000000001E11111111111111111
11111111111111111111111111111111111111111