1111111111111
10000000E0001
1000000000011
10001110CE001
1000111000011
10E0111000011
10000P0000001
1111111111111
