1111111111111
10000000E0001
1000000000011
1000111PCE001
1000111000011
1000000000011
1111111111111