1111111111111111111111111111111111111111111111111111111111111111111111111
1P00000000000000000000000000000111111111111111111111111111111110000000001
10000000000000000C0000000000000111111111111111111111111111111110000000001
1000000000000000000000000000000111111111111111111111111111111110000000001
10101010101010101010101010000C0111111111111111111111111111111110001111111
1000000000000000000000101111111111111111111111111111111111111111111111111
100000000000C000000000101111111111111111111111111111111111111111111111111
100000110000C000000000101111111111111111111111111111111111111111111111111
100000110000C000000000101111111111111111111111111111111111111111111111111
100000000000C000000000101111111111111111111111111111111111111111111111111
100000110000C000000000101111111111111111111111111111111111111111111111111
100000100000C000000000101111111111111111111111111111111111111111111111111
100000100000C000000000101111111111111111111111111111111111111111111111111
100000100000C000000000101111111111111111111111111111111111111111111111111
100000100000C000000000101111111111111111111111111111111111111111111111111
100000000000C000000000101111111111111111111111111111111111111111111111111
100000000000C000000000101111111111111111111111111111111111111111111111111
100000000000C000000000101111111111111111111111111111111111111111111111111
100000000000C000000000101111111111111111111111111111111111111111111111111
100000E00000C000000000101111111111111111111111111111111111111111111111111
100000000000C000000000101111111111111111111111111111111111111111111111111
100000000000C000000000101111111111111111111111111111111111111111111111111
10000000000000000000001E1111111111111111111111111111111111111111111111111
1111111111111111111111111111111111111111111111111111111111111111111111111