1111111111111
1P0000C000001
100C000000011
100011100E001
1000111000011
1000000000E11
1111111111111