1111111111111
1P00000000001
100C000000011
1000110000001
1000110000011
10000000000E1
1111111111111